ABBBBBBBBBBBBBBBBC
DEEEEEEEEEEEEEEEEF
DEEEEEEEEEEEEEEEEF
DEEEEEEEEEEEEEEEEF
DEEEEEEEEEEEEEEEEF
GHHHHHHHHHHHHHHHHI