ABBBBBBBBBC
DJJJLJJJJJF
DJLJJLKJJJF
DJJKJLJJJJF
DJJJJJJJKJF
DJKLJKJJLJF
DJJJJLJJJJF
GHHHHHHHHHI