ABBBBBBBBBC
DEEEEEEEEEF
DEEEEEEEEEF
DEEEEEEEEEF
DEEEEEEEEEF
DEEEEEEEEEF
DEEEEEEEEEF
GHHHHHHHHHI