ABBBBBBBBBBBBBBBBCABBBBBBBBBBBBBBBBCABBBBBBBBBBBBBBBBC
DAAAAAAAAAAAAAAAAAAAAAAAAAAAAAAAAAAAAEEEEEEEAAAAEEEEEF
DEEEEEEEEEEEEEEEEFDEEEEEEEAAEEEEEEEFDEEEEEEEEEEEEEEEEF
DEEEEEEAAAAAEEEEEFDEEEEEEEEEEEEEEEEFDEEEEEEEEEEEEEEEEF
DEEEEEEEEEEEEEEEEFDEEEEEEEEEEEEEEEEFDEEEEEEEEEEEEEEEEF
GHHHHHHHHHHHHHHHHIGHHHHHHHHHHHHHHHHIGHHHHHHHHHHHHHHHHI
ABBBBBBBBBBBBBBBBCABBBBBBBBBBBBBBBBCABBBBBBBBBBBBBBBBC
DEEEEEEEEEEEEEEEEFDEEEEEEEEEEEEEEEEFDEEEEAAAAAEEEEEEEF
DEEEEEEEEEEEEEEEEFDEEEEEAAAAAEEEEEEFDEEEEEEEEEEEEEEEEF
DEEEEAAAEEEEEEEEEFDEEEEEEEEEEEEEEEEFDEEEEEEEEEEEEEEEEF
DEEEEEEEEEEEEEEEEFDEEEEEEEEEEEEEEEEFDEEEEEAAAAEEEEEEEF
GHHHHHHHHHHHHHHHHIGHHHHHHHHHHHHHHHHIGHHHHHHHHHHHHHHHHI