ABBBBBBBBBBBBBBBBBBBBBBBBBBBBBBBBBC
DEEEEEEEEEEEEEEEEEEEEEEEEEEEEEEEEEF
DEEEEEEEEEEEEEEEEEEEEEEEEEEEEEEEEEF
DEEEEEEEEEEEEEEEEEEEEEEEEEEEEEEEEEF
DEEEEEEEEEEEEEEEEEEEEEEEEEEEEEEEEEF
DEEEEEEEEEEEEEEEEEEEEEEEEEEEEEEEEEF
DEEEEEEEEEEEEEEEEEEEEEEEEEEEEEEEEEF
GHHHHHHHHHHHHHHHHHHHHHHHHHHHHHHHHHI